########
# .   @#
#####  #
# $    #
#      #
#    $ #
# .    #
########